Unknown
20 10
3 3
XXXXXXXXXXXXXXXXXXXX
XXYYYYYYYYXXXXXXXXXX
XXYXXXXXXYXXXXXXXXXX
XXYXXXXXXYXXXXXXXXXX
XXYXXXXXXYXXXXXXXXXX
XXYXXXYYYYXXXXXXXXXX
XXYXXXXXXYXXXXXXXXXX
XXYXXXXXXYYYYYXXXXXX
XYYXXXXXXXXXXZXXXXXX
XXXXXXXXXXXXXXXXXXXX